R 500,500
NO ./source/grass.xpm
EA ./source/brick.xpm
SO ./source/brick.xpm
WE ./source/metal.xpm
S ./source/sky1_textrure.xpm
F 0,0,0
C 200,21,1

        1111111111111111111111111
        1000000000112222222002221
        101100000111200000W000001
        1001000000000000000002221
111111111011000001112222222222221
100000000011000001111111111111111
11110111111111011100000010001
11110111111111011101010010001
11002220211010011100000010001
100000000000000001100000010001
10000200000000001101010010001
1100000111010101111101111000111
11110111 1110101 101111010001
11111111 1111111 111111111111
