
NO ./source/path_to_the_north_texture
EA ./source/path_to_the_east_texture
SO ./source/path_to_the_south_texture
WE ./source/path_to_the_west_texture
S ./source/path_to_the_sprite_texture
F 4,32,123
R 100 100
C 0,2147483649,10

1111111111111111111111
1000000000000000000001
1000000000000000000001
1000000000000000000001
1000000000000000000001
1000000000W00000000001
1000000000000000000001
1000000000000000000001
1000000000000000000001
1000000000000000000001
100000000000000000000111111111111
100000000000000000000111111110111
111111111111111111111111111111111