R 1000, 1000
NO ./source/sky1_textrure.xpm
EA ./source/star.xpm
SO ./source/sky1_textrure.xpm
WE ./source/sky1_textrure.xpm
S ./source/star.xpm
F 0,0,0
C 200,21,1

        1111111111111111111111111
        1000000000110000000000001
        1011000001110000000000001
        10010000000002000S0000001
111111111011000001110000000000001
100000000011000001110111111111111
11110111111111011100000010001
11110111111111011101010010001
110022222110101011100000010001
10000000000200001100000010001
10000200000000001101010010001
1100000111010101111101111000111
11110111 1110101 101111010001
11111111 1111111 111111111111
