R 500,00000000000000500
NO ./source/grass.xpm
EA ./source/brick.xpm
SO ./source/brick.xpm
WE ./source/metal.xpm
S ./source/barrel.xpm
F 0,0,0
C 200,21,1

        1111111111111111111111111
        1000000000112222222S02221
        1011000001112000000000001
        1001000000000000000002221
111111111011000001112222222222221
100000000011000001111111111111111
11110111111111011100000010001
11110111111111011101010010001
11002220211010011100000010001
10000000000200001100000010001
10000200000000001101010010001
1100000111010101111101111000111
11110111 1110101 101111010001
11111111 1111111 111111111111
