R 1000, 1000
NO ./source/grass.xpm
EA ./source/star.xpm
SO ./source/brick.xpm
WE ./source/metal.xpm
S ./source/barrel.xpm
F 0,0,0
C 200,21,1

        1111111111111111111111111
        1000000000110000020000021
        1011000001110000020000021
        10010000000100000200S0001
111111111011000001110000020000021
100000000011000001111111111111111
11110111111111011100000010001
11110111111111011101010010001
110022202110101011100000010001
10000000000200001100000010001
10000200000000001101010010001
1100000111010101111101111000111
11110111 1110101 101111010001
11111111 1111111 111111111111
