
NO ./source/path_to_the_north_texture
EA ./source/path_to_the_east_texture
SO ./source/path_to_the_south_texture
WE ./source/path_to_the_west_texture
S ./source/path_to_the_sprite_texture
F 4,32,123
R 1000, 214748364
C 0,21,1


1111111
100N001
1111111
