R 5, 5

NO ./source/path_to_the_north_texture
EA ./source/path_to_the_east_texture
SO ./source/path_to_the_south_texture
WE ./source/path_to_the_west_texture
S ./source/path_to_the_sprite_texture
F 4,32,123
C 0,21,1


11111111111111111111
10000000000000000001
10000000000000000001
10000000000000000001
10000000000000000001
10000000000000000001
100000000N0000000001
10000000000000000001
11111111111111111111